نزل الشاكوش أنا هنا قاضي | متصيتين إنتو على الفاضي
هعديهالك المرة دي | لو الكلام مش كاش أنا مش فاضي
الليلة دي Airplane Mode | شاب جامد ن*ك عايش في المعادي
فودكا روسي، بيرة ألماني | صاحبِك صوته عالي، أنا على الهادي
بيقول لي بعد إذنك | ممكن آخد شوية من الكاريزما
مش هتسلك Off-White يا بني | جاي من المستقبل، حاسس إني راكب تيسلا
Valentino لابس | شفت بلاد الغرب زي ميدو
Scarface, Al Pacino | إنتو ضايعين زي نيمو
إنت لسه بادئ وإحنا بنشطب | والأرانب هنا جاية تتنطط
ورق أبيض، هنخطط | الدماغ فوق، كله متظبط
أحمر على الشفايف، أحمر على الضوافر | سهر طول الليل، حب متواصل
نجوم السما فوق، شايف الشواطئ | الشمس طلعت وأنا تليفوني صامت
في المجال DMTالـ | الفيل الأزرق في الدماغ
بن لادن في الجبال | قاعد هنا لوحدي بس عامل إحتلال
دريب على إيدي حاسس إني ثانوس | في الكاس، كله في التمام Ciroc الـ
فيس تايم جابرييلا من ميلانو | من أيام أدريانو Inter بتشجع
قربت منها سيكا قلت جملة عيب | عايز أحط السكر على النسكافيه
حاجز ترابيزة، جاية ولا إيه | حبيبتي درجاتها عالية وبتلعب باليه
Bentley حلمت إني بفول | موديل على يميني وبتزود درينكي
Kinky ،ومشوك Choker لابسة | Fendi ،وش على تي شيرتي ومبوز
وش غضبان وش غضبان | في السكة فيه اللي عطلان واللي هربان
VETEMENTS على COMME des GARÇONS | هيروشيما على البيت، كله حران
سر فيكتوريا إتفهم | دُست بنزين، كله إتركن
في تيسلا، فبسابق الزمن | أنا الحكم ،VAR هنا مافيش
نزل الشاكوش أنا هنا قاضي | متصيتين إنتو على الفاضي
هعديهالك المرة دي | لو الكلام مش كاش أنا مش فاضي
الليلة دي Airplane Mode | شاب جامد (ن*ك) عايش في المعادي
فودكا روسي، بيرة ألماني | صاحبِك صوته عالي، أنا على الهادي
بيقول لي بعد إذنك | ممكن آخد شوية من الكاريزما
مش هتسلك Off-White يا بني | جاي من المستقبل، حاسس إني راكب تيسلا
Valentino لابس | شفت بلاد الغرب زي ميدو
Scarface, Al Pacino | إنتو ضايعين زي نيمو
خدت النص، إديتها النص | جيت تبخ، أنا جيت أرش
في صحتنا، شلة توب | قعدة حلوة جوة الشيراتون
معايا موزة، معايا خوخة | الجسم متخلف زي إزازة كولا
لما تلف تعملنا دوخة | آيس كريم، آخد أنا بولة
الختم على لساني ستامبا | في دماغي مكهرب زي اللمبة
حاجز أوضة لينا في اللوكاندة | أديها بوسة لو الدنيا ضلمة
معايا ست ستات، أشرف عبد الباقي | مادة حلوة مش هتشوفها تاني
عالي زي الكاليماري Taste الـ | واخد زاني بس واخد بالي
هاخد صورة هات الكاميرا | عندي فرقة متكاملة
أمورة إنتي جامدة | معايا سوس خدي بق فانتا
شايل بس مش متضايق | مر دايق بس مودي رايق
لسه قايم ليا مدة نايم | بس دايماً على المجال دا فايق زي ما إنت شايف
بيج بوس، دماغ سم | ماشي مظبوط زي بيج بين
Lose lose, win win | BM دماغي مكنة
زي ما يكون كل اللي بيحصل مقصود، بيبي | ورق مختوم، دنيا ومصيرنا محسوم، بيبي
عقلي مسكون، غابة والقلب مرحوم، بيبي | بس أنا مجنون طالع للـ٧ نجوم
ربع قرن، ربع مية سحلة | صحراوي خدي سحبة
عسلية، زي النحلة | إنتي حلوة بس الكاش أحلى
حاسس بالمفعول إبتديت أروق | فوق السما فيو فحبيت أشوف
أنا مظبوط لا ماتركزوش | Alley-oop علقهالي هحط
حياتي فيلم مش حلقة | كينج كونج جوة الحلبة
باينة شايف ورقك | لعب شمال زي ألابا
معايا موزة معايا خوخة | مارو مافيا من أيام ما كنت في روما
لم بالشمال زي مارادونا | فرقة متكاملة، خدي صورة كوداك
واء واء، قول له سي لا في | ناس بتعيط على تلاكيك
أزرق وأصفر، دراويش | نزلت أجيب الجون الدهبي
بوم بوم طم طم | مارو دنجوان زي فان دام
مارو هداف زي هالاند | Meet me at the London قول لها
معالج المجال في وقت كوليرا | سنة ورا سنة أدوار دومينا
لسه فانتوم الأوبرا | بعد الكورونا هقلب القاهرة فلوريدا
زي ما يكون كل اللي بيحصل مقصود، بيبي | ورق مختوم، دنيا ومصيرنا محسوم، بيبي
عقلي مسكون، غابة والقلب مرحوم، بيبي | بس أنا مجنون طالع للـ٧ نجوم
أول ما الحكم ما يصفّر | في خدودَك الدنيا بتمطر
لما بطلع موبايلي | كل الشباب بتتوتّر
كل الشباب بتتخابث | باخلص معاكو واقوم لابس
باوصل الربح للهامش | انت في المركز الخامس
مش باحاول أأذيكي | دا كان فاول تكتيكي
شد فرامل اليد | الـBM ألماني التخميسة أمريكي
أبيضاني أفريقي | جلدي لون لافاش كيري
يا اسطى انت كليشيه | يا اسطى انت تقليدي
بلعب كورس مع اصحابي في نادي النورس | بستخبى عشان عليّا العين زي حورس
هرجع في آلة الزمن وهنشر الراب في التاريخ | على أيام الفراعنة فين توت عنخ آمون ورمسيس
لما الاقيهم هقولهم: لو دكورة انزلوا بيف | طبعا هيوافقوا عشان ما يتقالش دا جوز كساكيس
هبدأ الباتل بوورد بلاي احطّهم في الكيس | هقول لرمسيس … يا اسطى انت سيس
ادّي الورد بلاي التاني على طول | هقول لأ مش عطشان، مش عايز اشرب توت آند لامون
هكسب البيف… كدا هبقى انا فرعون | كدا مسألة في الجون
هنزّل كذا ألبوم | ومهمن كان اللون هحقق أعلى إيرادات في الكون
هخترع التليفون وهسمّي شبكتي "فودا فرعون" | بس يا عم طلعت بجم
كدا اجيلك على السكن | بجري ع البيت زي ميسي
انت بتجري ع البيت زي الحكم | بيتزا ع البيت
بدماغكو لفّيت | شبيك ولبيك
عليّا الطلاق اتخضيت | على الأغاني بتدرب
هنا في الديسكو انا مبلّط | مارو مش عارف أوصل لك
أيوة ما لازم تتسلق | أيوة الموضوع مش بسهولة
خلّص بس سنة أولى | سقطت تاني؟
لا لا لأ ، مش معقولة | كلامي عالي عالي أيوة فوق إدراكك
ما تحاولش تفهمه ممكن تخلص بإصابة | الشباب دا زي الورد غرّقته في الفازة
أقول له مين؟ ما تخافش قول له: بابا | شايفك بتعاني وفي كل بوستاتك بتقول: انا عادي
بس انت متضايق وواضح ان انت كواحد مبتدئ محتاج لدعاوي | فأنا باقول لك أهوه: ما تعيطش
بتصوت عشان الواي فاي ما لقطش | هكسّر التاتش
واقفل لك الماتش | واشتمك باللفظ
من غير "لا مؤاخص" | ماريو شركة إنتاج
كليب في ساحل العاج | مُزّتين جنب بعض
زي اسمي والتاج | على طول فيش لاج
مش مطلوب فيدباك | جنبي نجمتين شباك
بيسمّوني كيباد | ثانية بس كدا عشان افهم
لو انت رذيل أنا أرخم | جوا دماغي دا منجم
منجم ، منجم | ثانية بس كدا عشان افهم
لو انت رذيل أنا أرخم | جوا دماغي دا منجم
منجم ، منجم | عمري ما كسّلت في رابع بار
اعتبرني تامن جار | بس ما بدفعش إيجار
حماقي ع الشر أنا ناوي | على الفلاشة بلاوي
أنا بتصرف لوحدي | انت بتكلّم ببلاوي
لابد أن تجاوبُني | هو انت بجد ليه ودِني
خلاص معلش ، C'est La Vie | دماغه حلوه بس لعبي
كالعادة بتناموا في الحلبة | وبتقولوا جات بالحظ
بعتبر الكورة دي ورقة | بحطّها في المقص
شاف انيابي لما بص | آه يا عيني على الرص
توم جري ورا جيري | فجيري أخد منه فص
ثانية بس كدا عشان افهم | لو انت رذيل أنا أرخم
جوا دماغي دا منجم | منجم ، منجم
ثانية بس كدا عشان افهم | لو انت رذيل أنا أرخم
جوا دماغي دا منجم | منجم ، منجم
ممنوع الاقتراب او التصوير | طريق اتجاه واحد والمشي بليل بيكون خطير
انا مش بطير, بس ساعات بشتري ريد بل | سايق ميكروباص لقيت العفاريت ركبوا
ايه يا رجالة علي فين ؟ | قالولي امشي يا ابني
كنا مشينا بدري تلتاية هيفوتنا ماتش الاهلي | مروان وبشير، مروان و بشيرن مروان عدي وفات
كابتن سؤال, هو في منك معلبات؟ | وضع الثبات مع اني يوم السبت ببقي مأجز
مأجل شغلي عشان اطلع معاش قبل ما اعجز | قاعد بتعارك مع الهكسوس ده مش كابوس
جاي ادوسهم باللانسر رمسيس سيبني افوت | اشطة ضيعتوا الدنيا شوية مش بايدي
انتوا تعابين البحر بس بالانجليزي | شغلك فيك و بصراحة شكله صيني
"شغلي الماني ومتقفل في مصر" مرسيدس | تلعب بنش ؟ مابيبنش
بيقول مفيش معلبات اشطة طب هاتلي كانز | علي اخر الزمن انت الي هتتكلم؟
يا ابني قولتلك ابعد عن الزفتة هتتذنب | ايام المدرسة مفيش مدرسة كان يفهمني
غيرك انت يا صلاح يا عاشور, حبيبي تسلملي | في رابر اسمعه اقول يا بخته؟
لأ مفيش | طب في البوم نزل يتسمع لاخره؟
لأ مفيش | حاجة اتشهرت في المجال ده غير وساخته ؟
لأ مفيش | حد جاحد؟
لأ مفيش | ولا حتي واحد!؟
لأ مفيش | طب مفيش تراك نزل شدك؟
لأ مفيش | طب تيجي حفلة نشوف الواد ده؟
لأ مجيش | طب مفيش حد فيهم يتصدق ؟
لأ مفيش | حد عدي؟
لأ مفيش | ولا حتي أدي!؟
لأ مفيش | بشوي لحم حمير علي لهيب الانفجار
استغلالي بس اسيب الاختيار | اشترتلي قصر جديد جنب المطار
معرفتش ادي بقشيش, معاك فكة مليار؟ | فاضلي شوية واقفش المجال لنفسي
فارد ضهري ع السطح واخد تان رسمي | ابيضاني و اشقر, طويل ورفيع
عالبيت انت بيض جبتلك بويا تتبيض | بعت لابتوبي للقرصان بطلت ابقي بروديوسر
جبتلك بغبان اعملي بيت يا يوسف | زي الماوس الي بتحلق بيه
احلم انك توصل للمستوي | حياتي فيلم فمتحرقليش
متحزنليش..ارجوك | لبنة بزيت زتون
اتجوزت البيت الواد ده مقاليش مبروك | انت مدلوق عالبيت فيرسك مش مظبوط
انا بتبقي فجر اكتر, ليه؟ عشان داخل ببرود | مبروم علي مبروم .. ميرولش
لو متضايق هشكك زي القنفد | منتج, ف البيتات كل حاجة حلوة زي جروبي
انزل اركب عربيتك وكمل دغري | لحد اقرب حيطة البس فيها وخلص نفسك
نفسك تنافسني بس للاسف مزيكتك سكا | رونالدينيو انا رونالدينيو
مزيكتي معمولة من واحد الين بترجمله | شاب حاول يدخل الستوديو قفلت في وشه الباب
لو انت كنت مخرج كان اسمك هيبقي محمد خاب | خلي بالك من انيابي انا قرش بيتلكك قاعد تحت المياه بقول حادي بادي
بس دلوقتي انا شبعان | اصحابي من الصعيد, وصحباتي من لبنان
بشوط من بعيد وبجيب في التسعين يا مان اسف | قومت الجماهير عملت داب و قمت كاتت
بشرب بيريل وقلت للشباب انها بيرة | قولتلهم اني باكل بيتزا في الحقيقة فطيرة
رجعت بالزمن حطيت في جوجل خمسة ليرة | وانا هناك قابلت دونالد ترامب قلتله يا ابني سيبك
هستنكيص واسمع ام كلثوم | وقلت ابتدي عزف عالانون
اتغديت وشربت ينسون | حليت بجيلاتي طعم الشطة واللمون
مسكت الموبايل لقيت رنة من ابو الهول | قلتله يا معفن سايبلي ميسد كول
قالي طب انجز عايزين ننزل النهاردة | اعتذرت عني ديت مع "كيم كاركشيان" في جنينة مول
قاعد قعده اكشاك | انا ومايكل بالاك
قاعد بهايبر رحنا هايبر جبت قهوة بلاك | بسايفر فيديو ابيض واسود لابس ١٠٠ لون
حسام حسن اني اسجل يعني اجيب اجون | عرفنا ان انت مش حقيقي انت كارتون
محدش بيسمعك بجد انت كول تون | حاولت اخد منشطات ومنفعتش
مزيكا تفكرني بايام ما كنت تربل اتش | مزيكا تفكرني بايام ما كنت صغير
البوصلة ضاعت، في المحيط | رسمت الطريق من أول وجديد
التشابه بين الفجر وغروب الشمس بالنسبالي كان شيء غريب | حياة وموت، زائد سالب
بين الأتنين إنتي في عالم تالت | عمر طويل، بس في ثانية خانِك
لو رجعت بينا، زي ما كانت | بصيت لفوق عملت فحص
موّت جوّة نفسي كذا شخص | مفيش حد فينا مبيغلطش
أنا وضميري في مسابقة رقص | أنا بحاول أفتكر كل الليالي اللي ساحت في بعض
أيامها دنيتي كات سهلة بس أنا اللي فضلت مصمم ع الصعب | بحر كبير، مش عامل صوت
نور القمر سايح على الموج | بنموت من الخوف، ونخاف من الموت
كلها شوية ونطلع على فوق | دا اللي عندي، دا اللي عندي
ناس كتيرة مبقيتش جنبي | هما المفروض كانوا يشيلوا عني
مبينلهم إن الدنيا بمبي | عايزين يقروني زي الكتاب
ف إديت لنفسي شوية التعليمات | وش بدون أي تعبيرات
مطبات، ملفات | الناس دي عاملة زي البلالين
حابس جوة نفسي مساجين | وسط الزحمة نسيتلك أنا مين
حاسس إني لوحدي وسط الملايين | ملامحي إختفت مخي إبتدى يسيح
والبطاقة طارت مع الريح | مفيش مستقبل ، مفيش تاريخ
في دلوفتي ، عايز أعيش | عايز أعيد، عايز أتحول
بقولها كتير، وبتتفوت | عايز أحس إن في شخص إتكون
عايز العبها تاني من الأول | مصيبة لو فضلنا زي ما إحنا
قضينا وقت طويل ليلاتي بنحرق | بدأت اتغير وأنا في نص الرحلة
فهمت نفسي وأنا في قلب الوحدة | بنيت لنفسي مراية جديدة
شمس بعد ليلة طويلة | جِهزت وطلعت ع السفينة
بس الدنيا دي غريبة | أصل البوصلة ضاعت، في المحيط
رسمت الطريق من أول وجديد | التشابه بين الفجر وغروب الشمس بالنسبالي كان شيء غريب
حياة وموت، زائد سالب | بين الأتنين إنتي في عالم تالت
عمر طويل، بس في ثانية خانِك | لو رجعت بينا، زي ما كانت
بصيت لفوق عملت فحص | موّت جوّة نفسي كذا شخص
مفيش حد فينا مبيغلطش | أنا وضميري في مسابقة رقص
أنا بحاول أفتكر كل الليالي اللي ساحت في بعض | أيامها دنيتي كات سهلة بس أنا اللي فضلت مصمم ع الصعب
لسه على معادنا | لسه على معادنا
اصحى للكلام بنحط أجوان في أي هجمة | جاي في قصف الجبهة
تبقى عيل اهبل | من دلوقتي عايزك تمشي بشويش على مهلك
اهلا بيك في نهاية العالم | جينا نولعهالك
احل اللي مقدرنيش لا يسطا دي استحالة | يسطا دي استحالة
لسه شايلهالك | كل اللي انت قولته هانزله على دماغك
انا جيت قدام | انا جيت قدام
مسمعش صوتكو ويلا. كلو ويربط الحزام | هانقلب الميزان
هنولع في المكان | مش هنولعها بنزييييينة ولا بركان
هنولع هيروشيما | هنولع نجزاكي
وقفت معاك في الصعب يا صديقي ودي جزاتي | بتشك ف انتمائي
يا عم هو انت لاقي | فكر كويس لو هتاخد خطوة في اتجاهي
هاندخل اراضيكوا | ماتخافش هنراضيكوا
في ذخيرة كتير يا زميلي مش خسارة فيكوا | يسرق نقطع إيده
يهرب برضه نجيبه | ايوة دي النهاية
النهاية ليكو | داخل بشد في اجزاء وباقول ولا حركة
يا راجل مارضيتش اهينك واخد منك البت رغم ان كات فرسة | ولا تيجي تترجاني، ولا تبعت ناس من طرفك
اكتر واحد متكامل في اللعبة الباقيين كله ماشي بالبركة | لا احنا مش نفس الدرجة
انا في حتة تانية خالص | انت بس اللي بتقارن
انا بصراحة كان نفسي احلك بس مجاتش معايا اصل انا ظالم | ع الويب كلها مكشوفة
بتبلع وبتبدأ هرتلة | إعرف بس اني هاشوفك
لما اشوفك هزعلك | شكلك ياباشا مش فاهم اللقطة واللي اقدر اعمله فيك انت وشلتك
بين القوصين انت زي قلتك | عيل اهبل بتمنالك الشفة
انا واخواتي بنوصل وننفذ بشياكة عمرنا نوسخ البدل | محدش رباك انا فاضي اأدبك
تتشال وبتتحط هاشيلك اهبدك | انت كدا جيت لحد هنا ف باقول لك استحمل
يسطى انت كدا غلط ومافيش راجعة بالنسبالي بعد لما أحلف | طيبة فيا بس بحدف
اصبر ثانية انا فهمنتها | كل اللي جاي من دهب
كدا خلاص انت وقتك انتهى | مهما عارفت وحاولت تمِدها
نعلقكوا ونفرج عليكم البشر | عدى مدة ولسه فاكر الحركة مش مسامح اصل دماغي دي حجر
في الف واحد واقف برة تبعي وممكن فجأة تلاقي المبنى دا انفجر | ولو هتهرب من نفسك ومن الماضي برضه هاتهرب تهرب م القدر
فاضل 10 متر للخطر | مش هانسيب حد فيه نفس
لقطة معايا تودي ع الكفن | تقل معايا تدفع التمن
كله اتكشف كله اتكشف | اول الشمس ما بتنزل
نيجي الساحة وبننسف | كله اتمسك وبينزف
بتسوقها يسطى على نفسك | تيجي عندي وبتركن
كدا النفسيات سلكت | العيال خلاص هربت
اضرب في المليان متفكرش كتير | جثث جثث جثث على الارض كتير
صحيت من نوم طويل على عرش كبير | فهمت دماغك فين محتاجتش تفسير
كله عيار تقيل بضرب في المليان | بغطس بالايام واطلع م الدخان
غيرتوا الالوان كل دي افلام | لما الحق يبان ماتكونشي قلقان
قفلنا العداد، قفلنها العداد | سخننا الاجواء زي الترموستات
هانجيلك ع الباب تهرب م الشباك | اسفين ع الازعاج فيش حق بيتساب
بتتصل تاني: ريدايل | واحد في المية ع الموبايل
في المجال دا بالكامل | واحد في المية عنده ستايل
بقية الـ ٩٩ سردين متكومين | اصحابك صفر ع الشمال
اصحابي ١٠٠ ع اليمين | اصحابي عايزين بس كاش دروجا
معاهم شوية حريم G star jeans | عيال مالهومش في الرومانس
فيش مشاعر جينا بس ندكّن ملايين | جينا نسوق العوق ع الشيطان
عالي في مودي وعالي في الأرقام | مارو تراب دا ولا مهرجان؟
اسمع واسكت بلاش فصلان | اسمع واسكت انتو ع الحركرك
بارد زي موسكو بارد زي اوسلو | معايا بيظبط Codeine زي بوفلوط OG
بيوسعلي الأفق طاير مع السفن ، ملك أمنحتب | الاخضر ع الدولار ، بيخلص الجمل
في الماتش انا مولر ، في الحلبة كونور | والشباب في الدور الفوق فوق فوق
والستاف معايا موت موت موت موت | والموزايا معايا اي اي اي اي
داخل جوة اجيب الجون جون جون جون | دروجبا دروجبا دروجبا (اوه)
دروجبا دروجبا دروجبا (ايه ايه) | دروجبا دروجبا دروجبا (اوه)
دروجبا (اوه) دروجبا (ايه ايه) | مان الشهرة بتسكّر
دايما راجع متأخر | شارع تسعة اجيب دفتر
وبالمرة اجيب بطلر | وبالمرة اجيب التلج
سايق تيسلا للمرج | سبونسور معايا في مكالمة بس لسه زي ما انا فيش فرق
نفس الشلة فيش فرق | كل اصحابي معلمين برو
قافشين السين مش هانسيب برو | حاطط فانتا ع الكودين برو
يالا ننزل في الغويط برو | هظبط حساباتي واقفش البوجاتي وانزلها على البيت برو
اخواتي عايزين البواكي وعايزين بالنسياجا وديور بالعبيط برو | الحفلة تولع دا اكيد برو
في الصيف بحب ادوس بنزين برو | الخمرة بتطلب نيكوتين برو
في الصبح طالع علي هيثرو | بيكي بلايندرز انا تومي
ماسك تومي Al Capone | علي الموني jeff bezos
في الإنتاج انا سوني | حاطط جين علي تونيك
والشباب في الدور الفوق فوق فوق | والستاف معايا موت موت موت موت
والموزايا معايا اي اي اي اي | داخل جوة اجيب الجون جون جون جون
دروجبا دروجبا دروجبا (اوه) | دروجبا دروجبا دروجبا (ايه ايه)
دروجبا دروجبا دروجبا (اوه) | دروجبا (اوه) دروجبا (ايه ايه)
حاسب على سلاحك ، ساحر على الساحة | بيبي شكلك عايزة تاخدي قطمة م التفاحة
دخلت السين من أول لمسة | ودني فايقة مش بتفوت همسة
دروجبا ٢٠٠٥ | ملك زمني ، كنتش عارف تمني
وقتها لو فيه فيفا كنت حاجة وتمنين | دلوقتي تسعينات ، دلوقتي نجيب بلاك
دلوقتي بنطبع ميم ميم على المنتجات | كمان شوية نبقى جلوبال
كمان شوية نطلع على اكتوبر | سايق ولا ناخد اوبر
انتو بايظين جبتلكو فايزين | نامو بدري عشان بكرا تصحو فايقين
فراعنة في المحفظة ، ناصب المصيدة | وانا في الأوفسايد زمايلي بيعملولي كوفر
عشان امضي Mont Blanc | وابقى مرضي
لا ماخدش رقم رمزي ، اخد بعضي وامشي | معايا ناسي جنبي
لو الليلة حمرة ممكن بكرا يبقى بمبي | زهقت من التأني ، الموضوع مكانش ذنبي
هو كدا هو كدا | مش فارقة معايا إنه يعجبك
هو كدا هو كدا | مش فارقة معايا إنه يعجبك
أشيك واحد ف المكان إنتوا مين إنتوا مين إنتوا فين | مينفعش أطول الليلة دي لأحسن آخدلي عين
علي وضعي زي الكيمو كونو | عيال ضعيفه كله غير لونه
كله ميه ميه كله بونو | كله ميه ميه كله بونو
عارف نفسي ومش بدَعي | بحبك لما تدلعي
إنتي نجمة نجمة نجمة | مش محتاجه تتلمعي
مش شايف حد في مستوايا | مفيش غير عظمة جوايا
بجد بعرف ليه بتغيروا | لما أبص في المرايا
نزلت وعمري ما سخنت | صاحبي إركن علي جنب
مشيت بدماغي وإتشتمت | بس خدت كاشاتي عالبنك
خدت كاشاتي عالبنك | القعدة عندك تبقي تحت الصفر
عندي نعلي التاتش ومتأسفش | عندي Models عندي شلة Fresh
إنت بتحقد بس مبتفرقش | هو كدا هو كدا
مش فارقة معايا انه يعجبك | هو كدا هو كدا
مش فارقة معايا انه يعجبك | بنزل صورة تقولوا ده إعلان
عارف فرق السلم والتعبان | عارف فرق الحقد والسلكان
عارف الفرق تراهن علي كام؟ | انا قاعد جوا دماغي بحسب هل دا لبس خروجك ولا بيچامتك
البنت لما بتيجي سكة بتدي إشارة الراجل بس اللي يفهمها | كدا كدا ف أول لحظه عرفتها إنك عايزها بإبتسامتك
وهي قايمة إدتني غمزة | وانا قاعد مش مصدق
بس وسيم وذكي وكل شئ محتمل | علي موبايلي فيه حريم بالهبل
بنحفل جامد زي ما بنشتغل | يوم الاحد بنعمل بالأزايز جبل
منزاملش الشله طفش | مبنمثلش ومبنعرفش
مبنجاملش ومبنلطفش | محتاج أعلّي دماغي تاتش
علي تاتش ، علي دماغي تاتش | علي تاتش ، علي دماغي تاتش
هدّيك سببين، الدنيا غريبة والغيرة في العين | 24 سنة صراحة مش عارف تيّارها واخدني ورايحين على فين
بحب الهزار بس حاسب النار | عيلتي من البلد وبناخد التار
وقت المعركة مش بدي إنذار | لازم قرار، حاسس ان انا في مطار
وصلت متأخر ومش لاقي تذاكر | الناحية دي مسافر ، والناحية دي مهاجر
بس من الآخر، اللي في أصولي ورجولتي دا نادر | وفي زمن السوشيال ، عبادة اللايك بتخلي المحترم كداب ومنافق
واثق من نفسي ومش لازم اتّنك في القعدة وأفهم الناس إني خارق | يمكن دي غلطة
شوفوا الأغاني اللي ضاربة | لأ المجال مش في ورطة
طبيعي الغلابة بتدوس على بعض عشان يبقوا في يوم من الايام العمالقة | ماحبش أشتكي
بحب أبقى واضح مع نفسي وادوّر والاقي غلطتي | فـ عرفت سكتي
هنا في دايرتي، أفكارنا في الجون وكلامنا منطقي | شوفت حب، كره، خيانة، غدر
الكلام رخيص والكدب سهل | بقيتوا إزاي أعداء ما كنتوا الأهل؟
بقيّم الشخصية مش الشكل | بمناسبة الشكل
مايغرّكش لون الشعر | إنك تقل مني صعب
هتلاقي نفسك إتسرعت | هتلاقي الضرب ورا بعض
حقي بيتسابش والشخص اللي بييجي في سكتي بفضاله | لو مش وصلاله ف معايا الكتيبة هانسمم البيرة ونسرب اسراره
في الماضي فوّتّ في مواقف كتير واتخدعت | واتعلمت فيما بعد
إن فيه اللي بيهرج لو جت على حسابي هتغابى ، والذكرى هديها بالكعب | ننسى اللي حصل، لما ينزل المطر
وعد كان بيننا واتكسر | بنثق في كلاب، وبنخوّن البشر
شوفت سخرية القدر؟ | بتعلم احط للناس في التعامل حدود
الدنية ارانب واسود | في اللي هيحبك لله بالمجاني، في اللي بيخُون مهما كان المجهود
ممتن لمواقف خلتني ابقى راجل، | قدامي اختيار، وربما يكون خاطئ
مش هقعد أماطل | الدنيا بتتغير فـ لازم هنخاطر
هنجازف ونفوز مش هنعيش من سكات | مش بتتشاف ورا شيش وشباك
بفهم في الفن وبتكلم لغات | فعلا مفيش وقت للتأملات
ولا البكاء | الناس دي بتتباهى بالبخل
في حاجة أهم من الشغل | رايح البلد، راجع من البلد
كل إسبوع | عمري ما دوخت
عمري ما كنت أي حاجة غير أسطورة | برة المزيكا أسطورة
الناس دي مجرد مشهورة | في الحقيقة غير الصورة
جوايا وجع مش هاينفع يتحكي في اغنية حزينة | خواطر مؤلمة، نفسية تعبانة، عيون مزغللة والنية سليمة
عاملينلي اجانب | وبيكرهوا نفسهم... ارجعوا لاصلكوا الثقافة دي اتهانت
بنوّع بس عمري ما باتغير | بس بصراحة الدنيا معايا بقت بايظة
النَفَس بقى طويل تحت الميّة | والنفس بقى طويل لما افيّر
والحب كدا كدا مش مجالنا | واي حاجة غير التوبّ مش مقامنا
فيستايم ع الموب في المكالمة | فاتح هوتسبوت من الجنة
النبيت داب جوّه بحر روج | الجن بييجي لوحده مابنحضروش
الشباب دول مابيهزروش | الشباب دول مابيهزروش
ملك ولا كتابة ملك جوة الغابة | مش محتاجة هفرش هنا الاسد بدل السجادة
م دريب بجاكو تقيل جايبه م الوكالة | حبيبتي شبه اوريانا حاسس اني ديبالا
السوس في كل حتة معايا التسبيكة | داخل على الساحة ماسك استيكة
باصي باصي باصي زي لا ليجا | بعامل المزيكا زي ماتش فيفا
عايز اكتر | لسه بفطر الكارت اتشفر مش هوفر
شورت ازرق تشيرت اصفر | عيال لسه بتأفور
خدتها من ايدها ورتها الاستوديو قالتلي: اوه واو | كلّمت ألبير جهزت الكاسات وسكورت موستاو
وديت الإضاءة في الاحمر سحبت وباصيت الجواو | قالتلي انت فين قولتلها: بيلا تشاو
بيلا تشاو | 2 جرام M يعني ميم ميم
بتبعتلها هي تعمل سين سين | لو مستجدين نعمل سين جيم
جيت خليت السين سب ميت.. | جيت أودّي الأسهم، في التارجت
في العشا مع حبيبتي، فيش ماركت | الماتش الليلة في أرضي ولا في أرضك؟
خلي بالك النتيجة، مش في صالحك | خلي بالك انا مصيبة، وانا مصحصح
شايف الدنيا سلومو بس واضحة | لابس بنطلون لون لون الصحرا
حاسس اني في لولو لابس احمر | ماشي زي الدون ع المترونوم
جبت جون وانا في إيدي الميكروفون | طاير فوق شايف نهر الامازون
اللي فات كوم واللي جاي كوم | اللي فات نايكي واللي جاي هيرميس
اللي فات كاسيو واللي جاي روليكس | اللي فات نكش اللي جاي سوبليكس
اللي فات بوس واللي جاي.. | عايز افهم
جزمة بالينسياجا بيضة على مقاسها | هنا سوس هنا الشطة فين الدقة
فين الدقة | خدتها من ايدها ورتها الستوديو قالتلي: اوه واو
كلّمت ألبير جهزت الكاسات وسكورت موستاو | وديت الإضاءة في الاحمر سحبت باصيت الجواو
قربت منها سيكا وقلت جُملة شيك | زعلت مني، جبت ثلاث تفاحات من بورسعيد
قلبي ميت، مرحوم ادفنوه | في جنينة الحيمومات حطيت أفيون للاُسود
مش هاقول أمنياتي للجني خلاص ده وعد مني | نفسي بس في ساعة سويسري مصنوعة من معدن هندي
مفصول في أوضة الانتظار واللي جنبي قاعدة ترغي | بسمع الهضبة وهي بتسمع بوتشيلي
فأخدت حماري ومشيت | أخدت كليوباترا بار ورا البيت
بتقولي انا عايزة انفصال مش كوكتيل | طب عليّا الطلاق اتخضيت
كهربت الجو بنظرة ڤولتات؛ عينيّه شاحن | برينس في المزيكا منذ 1901
إيه يا ساحر؟ | ريحة الارنب في البورنيطة فاحت
دماغي جابت وش سليندر، الشخصية ساحت | إنسى غيرك
الكذب خيبة | والطول حتى لو بتشب هيبة
قلت لها: دوبي في الهوا ماليش في الكتمة | ليه تقارنيهم بالمستر؟ مافيش معادلة
هاتهم بالحب لو ماجوش بالضرب | كنا هنتصالح بس ما وافقوش عالشرط
إديت لك أصفر رغم ان المفروض كان طرد | انتو حرين، إدوا بعض بالجزمة.. مبروك عالأرض
ابتديت اتبسط رجعوني من الأجازة | في المكتب بازهق فبتفرج على روبي في الخباسة
سخنت، قلعت تشيرتي رموني في التلاجة | غرقت، بالغلط وانا باشرب لمون من الازازة
البت بارزة بره الدايرة زي الاوبل | اعجبت بيكي وبعد الفحص شايفك موديل
بانجز في شغلي، اسرع من آريين روبن | وحتى الآن لم أحصل على جايزة نوبل
جات بالصدفة | شفت وردة اقطفها
أظرفها لايك واكتبلها : بجد لُقطة | بالنسبالي الكراش ستافدت كراست او شوت ويسكي
كانت طالبة مني شوكولاتة، قلت لها: اتوكسي | المخرج قال لي إيه اللي انت لابسه دا، اللي موش من سنك؟
فحلقت شالابي مع مدحت، بالصدفة شفت منة | يانهار اااااابيض، وقف بينّا، خُش سِنّة
خليته يسبنا, ركبنا الفيرنا وللصبح سهرنا | بُست الاميرة.. طولت لساني...
بقيت ضفدع مش هستخدم تندر تاني | يا ريتك كنت اخترت كرامتك
ما قدرش يمسك نفسه، كَل الطَرْب في المطبخ | بدلْ بدلة ببطة، عشان سيء في إدارة الصفقة
تعمل نفسك فايتر ؟ سايبك في الحرب بتتشقلط | مهما تدي نظرة شر في بطاقتك
عمرك يا اسطى ما اتخطيت مرحلة المراهقة | ما فيش داعي
أحكي عن كل اللي شاغل البال | ماليش
مش.. مطلوب أكون حقاني | عشان كل ما أقول الحق بيتحداني
وآديني آهوه | باعلّم نفسي الكذب ثاني
لوجو باتمان على توكة الحزام | حبيبي سرحان صورتك من زمان
إمضي لي، أنا فان | هاتيلي تعبان
اقليلي بذنجان | إقريلي الفنجان، في تركمانستان
بُقين على سيراميك | لوكيني لما باسبيك
يا ابني كفاية رغي، صدعت والناس اتهرت | وش في وش والضهر دي كتابة ملك
المشرف قال لي ترفع ايدك، آكلك بسناني | فرفعت صباع ديناميت، نط من الدور الثاني
ولعت فيهم بالاغاني؛ جبهة نار | أيوة مارو نُص ألماني.. ودا استعمار
مازالت محاولات الخصم منخفضة | موش بنختلط، هجهضك زي بنت مرتبطة
إنت صفر باكرهك، بالقسط اوضبك | دايرة اصحابك: هاحطك، في الوسط وانتقدك
جريمة قتل والأداة مش طلقة، دا سيخ | شكلي كدة هاطلب بقى، مش طالبة طبيخ
بص ماك انا معاك او تيك اواي من تكا | رابر لسه طري زي البيتزا وهي بتسخن
انش جه وانشراح، موش مطلوب اي اقتراح | احب اقدم لكم مشروع الجاية جراح:
اخذت قطمة فينو وحطيت نضارتي عالكومودينو | الفيرس خلص مفعول الحباية راح
ما فيش داعي | أحكي عن كل اللي شاغل البال
ماليش | مش.. مطلوب أكون حقاني
عشان كل ما أقول الحق بيتحداني | وآديني آهوه
طرية الحتة دي مغربي، بنباصيها أنا وشلتي، آي | هدي شوية السعر غلي، بيلبورداتي ع الدائري، آي
ايه يا زميلي وحشتني، يلا ما اللي علي علي، آي | إفتحلي الأحمر دا وصبلي عندي العالي مين يشتري، آي
عندي العالي مين يشتري، آي | عندي العالي مين يشتري، آي
عندي العالي مين يشتري | عندي العالي مين يشتري
إفتحلي الاحمر ده وصبلي، آي | فيش أبطال ليه في البطولة؟
الناس دي خربت روحوها | بتقولي حاجة مش مفهومة
اديها هدية تكون مرلولة | بتقولي كلمة بالأسباني ماعرفوش يترجموها
زي دييجو مارادونا Blanco كدا كدا معايا الـ | دايرة بالحب بيخلص واصب
Top بشوف أنا فين لسه ع الـ | لسه بسخن إيدي بتلغم
مع ماريو في الماريوت كاوتشي بيدخن | العدة في الشنطة، السر في الخلطة
بالشنطة Bloody كاس وشوتين الـ | ‏في العين كل لما نكتر Bloody
في العين كل لما نكتر Bloody | Costa rica, Pura vida ،أسباني اقول جمل مفيدة
معايا ناس دماغها نضيفة، الناس دي عاملة دماغ نضيفة | مش رخيصة، كازابلانكا مش بعيدة Cocaina
لسه مقابل الحبيبة، مصري إيطالي انتي داليدا | هانطلع بيها لفوق Double black
بلد كاملة من البلاكون | Mira lo تشوفني تقول لك Chica
Vida loca vito Corleone, Ay | فيش اشتغالة، هاتلي صاروخ من التلاجة
بطلع مع ناسا، بطلع ع الشاشة | بعمل دماغ بس دماغي شغالة
Whoa, Whoa | عايز اطفي مش حريقة
علّي تاتش مش مزيكا | لسه الولعة بوديها
لسة مقابل الأميرة | لسه بتدرس في أمريكا
بمبوناية لابسة جيبة | هي تشبه دوا ليبا
ولا تقرب لـ شاكيرا | انتي كدا كدا قمبلة، ايه اللي جابك هنا عندنا؟ أي
معايا حاجة مش من هنا، اديكي شوية مش مشكلة، أي | سيجارة في ايدي متبلة، كدا الليلة متسستمة، أي
باعاني من العظمة مش عايز الدكتور يشفيني | في مطعم ايطالي بناكل تورتليني
بنده الجارسون بايدي | قالت: هاسيبك، قلت: سيبي
مش هنتخانق في حضور الامبراطور الصيني | بل هي… عودة الديبلوماسي
لبس النورميز مافيش منه مقاسي | املوا كاسي تاني وتاني بكذا ليكويد
دماغي بتجري كإنها فرود | في قلبي ذهب اسود
احنا النينچا | هانجيلك وانت بتحلم نحلق رمشك
ونقول لك محتاج تنشف | الولايات المتحدة المروانية هي جمجمة
واخد المعدية من إسماعيلية لقرطبة | مجالنا كام امبير؟ دا لم فطير
على الفيس انا أدمن جروب فانز محمه منير | دمكوا تقيل نفس وزن هم الفيل
شكلك مش بتستحمى كتير | شربوني مقلب بس سرب من الشفشق
لو ملكش ضهر هكسرلك رقبتك | في سوبرماركو الخريف اللي فات
كنت امسك قلم جاف واغير تواريخ الانتاج | اصلي باقدم خدمة
رز مكسرات وفخدة رجلك | السنة دي بصراحة تخنت من أكل الدهنة
فهاتلي زبدة | باقول ايه انتي شكلك قتمة
بس طييييبة قلبك هي اللي شككتنا | متفكرنيش باللي فات
٣ ثواني ما بيني ومابين الباب | لو مش مقتنع قول لي الحاجة اسمها
واجيبلك التليسكوب عشان تعرف انا فين | ع الروف وبافطر بيض مع جارتي
بتقول لي ظبط وهنبارتي | انا شايفك عشت الدور وطلع أرضي
الزيبق الاحمر في حنجرتي | مخبي هرم خفرع في حصالتي
الرغبة في الحياة حب استطلاع | موظف أورانج سأل فين الحب اللي راح
قلت اكتب ضاع | هي المكالمة دي بتتسجل؟
دنيس متبل | عزمت بيبو ع السحور: تيجي الدوسيت يا كابتن؟
مناقشة بكلام فصيح على صفيح ساخن | اهو الطبيخ داخل
طالب قرنبيط فاخر | شوية برفان يترشوا على الرايق
باكراش على لعب الكاندي كراش وانا سايق | مش قصدي الطعك بس رايح ع المطبعة
في منتهة السربعة كتبت سيناريو عمر وسلمى اربعة | بعاليصا! ليه بتسموها سهلابيسا
سهل تلاقيها، زي الرجولة في اهل الجيزة | هات لي استمارتك ع الشباك لازم مع صورة
اهلا بيك في إدارة الكلاب المسعورة | باسهر مع بت شقرة شاطرة بتذاكر كافكا في دفتر
واثقة وكاتبة ع اليافطة الصفرة "خطر" بالخط الاخضر | غور في داهية محتاج تنصحنا
واعتزالك، مطلوب... اكتر من تراك الرحمة | دا شيئ معروف يابني البداية كانت واضحة
عمرهم ما بيغلبوني تحسني المارد الاحمر | متفكرنيش باللي فات
ثانيتين ما بيني ومابين الباب | لو مش مقتنع قول لي الحاجة اسمها
واجيبلك التليسكوب عشان تعرف انا فين | في شارع تسعة في الحتة اللي بعد لتشي
وبعرج... في واحدة اسبانية ماسكة في كعب رجلي | هي هي.. تمها ايه الدنيا ديا؟
اسمعلاوي الاصيل من زمن الامبريالية | انا والفن زي الويچا والسحر
في إضاءة خافتة باغمس الريشة في الحبر | قعدت تقول لي دا شامب، اهو اتداس
دفنته بالفاس بدمه، والكاس بات في أسمنت ممتاز | روحت قشتمر اقرا لأميرة الفنجان
... خدي نفس... طلبت شيشة بتنجان | قولتلها جوك قدم زي مين في وسط ناو
معايا واحد برازيلي اسمه استيفاو | وبيللا حديد عايزه تاكل في نعمة، ماسمعتش م الهاندزفري
يا بيللا هو احنا ايه اللي يودينا المهندسين؟ | البت زعلت لازقة بوزها في الهواوي
مش عايز شكاوي، اتصالحنا وزغطتها عكاوي | يالا ...مش هنرضي الكل
الكولمان مليان بنزين | عامل دماغ ٩٢
دي لعبتي ...طفي السجاير في معدتي | دا الفصل التمنتاشر من مذكراتي، اكتبي
مبنى شعر يابني معندعكش ادنى فكرة | شايفك جبت ورا. ايه دا طب ما انت بتفهم
كاريزمة مين ياض اللي انت المفروض بتمتلكها | سألتها انتي لابسة ايه ف قامت قافلة السكة!
حسيت اني اتقدمت لاقتني رجعت لورة | حسيت اني اتاخرت لاقتني طلعت الهرم
متفكرنيش باللي فات | انا ع الباب
حبيبتي لابسة لبس غالي | عندها دريب زي دساني
شنطة louis كعب عالي | لسه راجعة من ميامي
هي بتحبني لما بقفش | آخري في المعاكسة ممكن اغمز
جتلي من نفسها ماندهتش | مافيا ع الهادي أنا مرجلچ
دلوعة وصوتها مبحوح | أمورة اديتها مصروف
تنورة وضهر مفتوح | خدي صورة الذكرى هتروح
كيلو م البتلّو على فحمي | تعالي اقفي جنبي وانا بشوي
بحب ائمن دايما على حاجتي | وديت النار الهادية على مهلي
مزة مش ممكن يا بروو | جبتلها الـversace كادوه
زمان كانت مودل دلوقتي بقت Unmodel | كلام اتقال علينا بس احنا مش كوبل
ياللا على ego نسوي شوية شوبينج | محتارة بين الاتنين ف اشتريت دوبل
نزلت قهوة تركي ع المظبوط | نزلتْ موكاتشينو مع البسكوت
ايه النظام بليل قلتلها هانشوف | عايزة تاخد رأيي في التاتو
سايق، ع الجلالة وهي جنبي | خايفة، بس مش بتقول لي هدّي
شنطة، جوتشي لون اليوستفندي | سويتر، انتي سوشال لونه بمبي
لايفستايل عمارة الإيموبيليا | تاتش ايس كريم بالفانيليا
نظرة العينين فيها كيميا | حاطة ميم ميم ع الماديلية
ووه، مزة مش ممكن يا برو | ووه، جاتلها المكالمة من Vogue
حبيبتي حلوة زي بيلا | لابسة Maison Margiela
بالطو فرو زي Cruella | ساعات بتـtrip بس بهندلها
زود الـH ع الحزام | زود ع الباستا بارميچان
بتطلع الآيفون ايه الكلام | صورة مش ستوري طب تمام
Gucci Guilty على جسمي | عندي دريب زي نسله
جزمة OFF على رجلي | ابعتي صورة if u miss me
ما تيجي نروح المول نعمل هاي سكور | تيجي نحط الشنجن عالباسبور
ماتيجي update زي app store | ماتيجي معايا اصحابي هاتي بلاس فور
مزة مش ممكن يا برو | نزلنا ال Moët & Chandon
داخل على البيت داخل أأذيك | داخل على الزيرو انا فظيع
انا مذيع أنا ماسبيرو | انا اللي بالعب، الباقي يتفرج م المدرجات
طالب مشاغب، في الحصة بانط ع الترابيزات | باكتب بالموس
إنت بلبوص | إنت بردان
إنت محظوظ | إنت محفوظ
إنت كسلان | ورقي استحمل، تعبتوا انا كتير لما قلمي زاط
في نفس المجال، بس لاحظ ان انتو مش شبهي خاااالص | قافش حرامي
بيقولوا يا مامي | تتعملوا عصير
أسميكو راني | تحس انه...
تحس انه فاضي | طاردهم بره
أحمد عرابي | باعمل أداء
قوة إنتاج | مارو بولدوزر
هز الشباك | هو المزاج
كدا جيم اوفر | انا وكيل النيابة، بيتحاسبوا، كلهم فاسدين
انا بانساش، فهاخلي اللي قفلوا السكة آسفين | ايدي في الجيب
لأه، في العين | رجلي في سنانك
دم ع السيف | بيبي في البيت
سيرتي في لسانك | رميت المجال م الطيارة ودلوقتي بيطالبوا بالتار
انا اللي واقف، والباقي من جيلي حصل له انهيار | فوّت الطيارة
بس انا طيارة | رابك مُضرّ
رابك سيجارة | باعبي كلام
عبّي في شكارة | باكتب في البيت
بيت الدعارة | داخل على البيت
داخل أأذيك | داخل ع الزيرو
أنا فظيع | أنا مذيع
أنا ماسبيرو | انا اللي بلعب الباقي يتفرج م المدرجات
طالب مشاغب في الحصة بانط على الترابيزات | بكتب بالموس
انت بلبوص | انت بردان
انت محظوظ | انت محفوظ
انت كسلان | ورقي استحمل تعبته انا كتير لما قلمي زاط
في نفس المجال، بس لاحظ ان انتو مش شبهي خاااالص | ينفع الفن يكون فن، لو هو تجاري؟
ازاي اكون راكب الموجة لو انا تسونامي؟ | قاااري
امتياز في الحصة وفي الملعب بالبّس كباااري | شااري
دماغي نضيفة، انا مشغل في راسي جواري | بس بس زهقنا
بس بس طهقنا | سايح ع المزيكا
حاسب بس الجبنة | حاسب بس يجي لك تعويرة يا سوسو
يا كوكو يا لولو مش هارحم، هاشوطه | الشرح للوضع: باديك بالبلوتوث
مهمل مش باخلي بالي من زوزو | حاطط الزبدة ع البيت
حاطط البيضة ع الديك | حاطط السعر ع الشيك
حاطط الويب ع الضيب | حاطط ال...
حاطط بشمالي، دا شيكا | حاطط تلاتة في بينفيكا
شاهد يا علي يا ويكا | شغل كل يوم بالسنتي سنتي
بادوس عليك كإني بالعب مالتي | مش هتاكل ولا تشرب مع فخامتي
تطول تنافس مين يا هانتي دانتي | من زفارتك فكرتني بالسمكة
ما انت جوا ايدي بتفلفص | ضربة حرة ديفيد الابا
قاتلهم انا كدا بالسامبا | كل الامسيز دي في الشنطة
تحية لمدينة طنطا | شادد المدة اللي فاتت، مش التاني والتالت
فقافش اللي عملولي عنتر | داخل على البيت
داخل أأذيك | داخل ع الزيرو
أنا فظيع | أنا مذيع
أنا ماسبيرو | انا اللي بلعب الباقي يتفرج م المدرجات
طالب مشاغب في الحصة بانط على الترابيزات | بكتب بالموس
انت بلبوص | انت بردان
انت محظوظ | انت محفوظ
انت كسلان | ورقي استحمل تعبته انا كتير لما قلمي زاط
في نفس المجال، بس لاحظ ان انتو مش شبهي خاااالص | نزّل عليهم ستارة المسرح
كل ما تقول لي: باكرهك، بفرح | كلامي بيتقال مرة واحدة تفهمي ما باحبش اشرح
بلاها جمايل من حد، الشباب دي كلها بتتمصلح | باشا م الآخر... لو بتكاكوا تتّبلوا ... كدا بص
لو انتو سنافر... سهل انكوا تتشربلوا... كدا بص | يا مان هتتاخر... وراسك هتقابل القنو... كدا بص
اصل انتوا فلاتر... وسخين، عايزين تتبدلوا.. ايه دا ايه دا بص! | ايه دا العيال دولا كبروا
لو انت بابا انا جدو | بس انت مش بابا انت ابنه
مخدة على الوش تتكتموا | سلسلة من مطر
عقلها راح واتصل | قلبها اتكيف فاتسطل
عيطت مش من البصل | بتبكي لاصحابها تشتكي تكي م اللي حصل
كنتي تاخدي مني حذر | بس انا حنين
طولت بالي اتشعلقتي، آه | والايام هتبيّن
اني اتصالحت مع نفسي، آه | واديني متنيّل
ناس مشاهير على شاشتي، آه | بس كنجم هاتعين
يا ترى مين هيفضل من كاستي | آه، انت بتستهبل
فيرسك بلاستيك | فيرس مفشكل
مش بافهم | لسه بتتعلم
كلمة حق | بتكدب، باقلب
مش هاكتم | لسه مش كابتن
باسأل نفسي ليه الشباب لسه بتمثل | وليه الرجولة بتعزّل
نايم كويس برضو مكسّل | قلت: انا برضو برضو أسطوري
لحد ما اليقظة تقابل الشمس | أملا العين بعرضي وبطولي
تقيل خفيف، أنا حابس الدم | المنهج دا بدون مدارس اتلم
بص للقهر | شاهد الغم
مارو الصقر | مش شايف النمل
مش شايف النمل | لحد ما في جزء من الثانية في الأولى والتانية
فتحت الكلام ضربات متتالية | بنزل كلامي بالختم الإداري
ما تقولش حبيبي، هات وشك التاني | ترسانة ترسانة ترسانة ترسانة ترسانة
بحر عالي موجه شديد | شايف الشط من بعيد
مية مالحة في صدري | الفرصة بتهرب مني
برضوا مافيش حد يستاهل | 4 ميسدات صحيت عليهم ولسه فاكر
لما الشبكة في موبايلي كانت م العناكب | مش باغرق انا باعوم
لو وقعت بارجع اقوم | مش هسكت انا هاقول
لا بالف ولا بادور | في عيد ميلادي جالي هدية
بس اللي جابها مجهول | كلميني بكرا لو عايزة
بس احتمال أكون مشغول | فين فين فين؟
في الشوارع المخيفة | فلتنا م التفتيش
عشان الشنطة كانت خفيفة | ويييييي…
نقطنا بسكاتك | الثانية بتفوت وبتروح في الزبالة
ف انا هاسيبها لك | الشُهرة قلابة
والضحكة كذابة | انا باهرب واتدارى
من غير ما أبقى خايف | السرعة بتقل طول ما انا مش سايق
مش حِمل كماين | جيت م المستقبل وفي إيدي جوايز
وجايز ما ارجعش لو ما فضلتش فايق | انا مصحصح
الحمل اللي انت شايله دا لمصلحتك | على راحتك
ليه فجأة كل حد بقى صاحبك | مفيش حد يستاهل الاتنين ميسد كول
اسرار في موبايل اتفتح من غير بين كود | العيب اللي فيّا
مش باجيب غير مية المية | ورجعنا نفس الشارع
كنا فيه من نص ساعة | لسه بيننا نص حالة
مستني الإعادة | العيب اللي فيّا
مش بغيب م المسؤلية | بالاقي نفسي في انفراد
ثواني قبل ما بتتشاط | قوام بيتفك الرباط
واكون ع الأرض | لسه فاكرين ولا نسيتوا؟
ما هو دا العيب اللي فيكوا | ماشي بالليل في مصر الجديدة
مش ساكن في مصر الجديدة | نتقابل في مصر الجديدة
شكلي هبات في مصر الجديدة | مصر الجديدة
مش ساكن في مصر الجديدة | نتقابل في مصر الجديدة
شكلي هبات في مصر الجديدة | بحر عالي موجه شديد
شايف الشط من بعيد | مية مالحة في صدري
الفرصة ... | معلش ما ردتش
كنت بادي درس الفيزيا | ساوند كلاود ستيشن روبابيكيا
جايزة أفضل رابر في افريقيا | مش هتفيدني في بيتس ولا فيتشر
انا متكااااامل… بوجبة | ثانية… في الدفاتر اشوف لك
طلعت جاية معاكو صدفة | سيني سيني سيني سينيمائي… سينيمائي
محتاج اركب عدساتي… على الهادي | دماغي نضيفة في الاغاني… دا اساسييي
حراق فعلا دا مش كنتاكي … دا وسابي | لسه بتقول لي كاني ماني… وبتهاتي
هبيتك في دواساتي… دي اخلاقي | شايفكوا دايما على شمالي… عبد الشافي
حاسّ اني سايق كواساكي …كواساكي | شوف البلاوي جوة شاتي… دي حياتي
الأغنية دي لولادي… وأجدادي | رجعتي تتدلعي تاني… بتتشاقي
خليكي عندك انا هاجي… في ثواني | لو مش عارف تسمع الاغنية جرب تشمها
لو مش عارف تبدع جرب تشفها | ايوة رجعنا نتكلم تاني بس دا من الزهق
بنت تافهة بس بتجنني لما بتهزها | اتنين في الدرج وواحدة على اللاب
انا مش انسان انا حيوان | دوّب المجال في طبق الشوفان
واخد المدام وطالع اليونان | …صعبة
ماشي مع واحدة شاقطها من المعرض | ثانية ثواني مالك مش على بعضك؟
فين المنافسة والله ماعرف | اوكيه! دي لقطة
سوري ماينفعش تشوف المطبخ | اوكيه! دا مقطف
هانتكلم بعد ما تتسطب | معايا العدة
معايا العدة | مش بنعدك
مش بالكترة | ولا بالشدة
هات الفكرة | وانا هدرسها
مش هتاكلوا معايا عيش | بتقاوحوا معايا ليه
بلسع زي الزيت | نازل زي السيف
فاكر لما زهقت وقمت جايب من الاخر | لما سخنت إتمدت إيدي ع المشاكل
عايزك تبعتي لي الصور بالفلاتر | واللوكيشن عشان لو عُزنا نتقابل
GPS | فكريني نسيت الاسم
بديكي الاذن | لما توصلي سيبيلي ميزد
GPS | فكريني نسيت الاسم
بديكي الاذن | لما توصلي سيبيلي ميزد
آه بانوّع بس عمري ما باتغير | رشيت المية كنت عامل فاير
بارقص صلصة مع الجبنة على بيتزا | باعجنها فبتزهق، وبتنده باتيستا
عامل لي جانجستا؟ اليسطا، حطيته ع الليستة | نطرته من على الكنبة، وديته مانشيستا
البت ريري ع الباب | بتدندن على ما اشغل السي دي ع اللاب
بتقولي عايزة اعمل اغنية زي الواد اللي بيقول | ريريريريريريري ع تراك
في حضوري بتشب شب، وانا دايس في خرا حافي | هزاري وزنه طن، تتضايق من حركاتي
في هوليوود سرقت تمثال فرعوني، قلم BIC | ويل سميث طلع هيتيا، بس چوني قلب دب
أنا البوب أنا البوب أنا البوب | مارو كان شغال زي المكنة، وقلب توب
كتبت الفجر، صحيت لقيت اللي اتكتب فُجر | تراك نزلته وانا في الاجازة عمل شغل
منور على البيت زي الفوانيس | يا بيت مش فارقة، طول ما احنا سوا انا بيس
لأ دا مش مُنتَج، هتبيع لي ازاي هوا في كيس؟ | دماغك جزمة؟ يبقى القفا دا الورنيش
جنة جنة، آه جنة | رايح فين في وسط الماتش ياااض استنا
ع الأقل خد لك وانت طاااالع ستامبا | خليل: بعمل عليكوا كوميدي ستانداب
استنضف، مع تايد للغسيل | شطفتك، مش عارف إيه البديل
حطيت عليكو من روسيا للبرازيل | بالاغي قروش وباتصل بالدرافيل
رنة رنة اه، رنة! | مخك تخين، بتحشه زيت وزبدة وسمنة
احدفك في راسك ياض بقطعتين دجاج مجمد | اسوح لك دماغك ..من غير ما تروح هولندا
فيش مني اتنين فبدوّر | أتكلم ليه ما انا اعوّر
شُبيك لُبيك، أتهور | ضلمت البيت فبنوّر
ولا صوت وانا داخل الفصل | إرفع ايديك انت fake وبتزوّر
مش سطحي في نفسي، دا مش شخصي | بادخل في الشئ وبغوط
اغانيك. ليه. مش. في. الراديو | عشان انا حقيقي ومش فالصو
سخنان؟ طب ليه يا حبيبي لابس بالطو؟ | جمدان لا إرادي بازعلكوا
خد شورتي: برة القميص | شيك، زرر وقيس
شيك، لندن باريس | سينجل، برضو؟ العريس
كلام ورا ضهرنا قلبنالكوا | وكبير المجموعة دا أفشلكوا
الواد ماقالش عاش فاغتلتوا | قالتلي واقف برا فدخلتوا
زهقت من القاهرة، ف في اجازتي طالع سينا | نازل مع الهضبة، فكس لي وراح لدينا
بالاباتشي قمت راجع | فوق مدرستي قمت لاسع
باراتكوا عايزه الشنق زي دونالد | باراتي في الكافيه مع روجينا ومي عمر
اسكت يا اسطوانة، عمك ماريو ديچيتال | اتعرف ع السنجاب، اصلك عامل زيه تيبيكال
متقولش ماريو حاف هتقول السيد، قشطة؟ | تتليف على خير على ما تليل، تصبح
شخص مشوه من افلام الخيال العلمي | لو طلع زكي احتمال اسيبه يقابل حلمي
هاقول لك وَلّع لو بتمل ودفّينا | اصل بصراحة القعدة تشل: بنزينة
٩٥ هي السنة اللي اتولدت فيها | جبت مشّاية وجَرّيت الوقت بيها
لحد ما اتعمل عليا غارة في السيارة | (ليه؟) عشان شربت سجارة في الطيارة؟
قنبلة الموسم، اسمي بيضرب فيكو | رميتهم في الزيت قلت لهم: ديسباسيتو
يتكتب عنى عشان باحطم الأرقام | افضل استهبل، اقوم حطك في الجرنان
بلوة... حبيبة القلب اسماها سلوى | اروع حاجة فيها ان جسمها مسلوع
ابعتك تجيب لي طلب ليلة عيد ميلادك | اديك روسية تقول لي يخرب بيت دماغك
فكرة بنت دوجز | هضرب استروكس
اكلم نفرتيتي اقول يا بت ابعتي نودز | مش هاتسبني اخش قبلك الحمام
طب كدا ماحدش سابقك... وانا مادّك ع السخان | البوب مقدم لك كاسات فخفخينا
كلامهم عنك غلط، مش لأن كذابين | مش فاهمين، أصل اللي زيك عن جيلهم متقدمين
مش فاهمين اللي زيك من تفكيرهم متعذبين | كنت سايق في الضلمة، لقيتك بتتمشى على اليمين
ركبت جنبي زي أيام زمان، أنا وانت على الطريق | بالصدفة في اليوم دا كنت قاعد بافكر فيك
كنت في منطقتك وحاسس اني هاشوفك | الدنيا خلتنا نتقابل وسط جهنم
جهنم ليك، جنة جديدة ليا | اللي مخليك تتعذب فيها انها في يوم كانت جنة ليك
بُص لي، ولائي ليك، لازم تتأكد | موبايلي رن تاني، هاقفله، مش عايز اتشتت
بمناسبة الكلمة اللي قلتها لي أول ما ركبت | إعرف ان استحالة اني أخونك، انت اخويا
بقى لي فترة عايز اعاتبك، شفتك وافتكرت | عمري ما هتضايق منك عشان عمرك ما قصرت
عزيزي الإنسان | نفسي اموت الناموسة اللي مش بتخليك تنام
عزيزي الإنسان | نفسي بجد اسعدك، مش عارف اعملها ازاي
سألتك إيه الأخبار؟ قلت لي: مش تمام خالص | فترة الاكتئاب طوّلت، راحت راحة البال، طارت
في آخر فترة قلّ الكلام بيننا | ولأسباب تافهة كنت زعلان منك
كلام سريع قبل ما توصل مكان ما انت رايح | بتوصف لي الطريق، في نفس الوقت بتديني في نصايح
كإنك بتقول اتعود على وجودي قليل | كأنك بتقول فيه شيء هيتغير قريب
مدخل دماغك فين؟ | دايما بتخلي الكلام عليّا، مش عليك
صاحبنا التالت خايف عليك اكتر مني | ولو حصل لك حاجة هايتجنن
حاجة حسيتها من غير ما يتكلم | يمكن قليل الناس اللي بيفهموك بجد
وبالأغنية دي مش باحاول اقول لك اني منهم | كل اللي حصل اني شفتك وافتكرت
اني مش متضايق منك، عشان عمرك ما قصرت | عزيزي الإنسان
نفسي اموت الناموسة اللي مش بتخليك تنام | عزيزي الإنسان
نفسي بجد اسعدك مش عارف اعملها ازاي | ليلة غريبة.. حبينا نقف وما لقيتش الركنة
عربيات يمين وشمال مدية انطباع الزحمة | في نص الجملة لاقيتك نزلت فجأة
اتفرجت عليك وانت داخل المبنى | وقولت لنفسي يا رب تلاقي اللي انت محتاجه عشان تكمل
من كام شهر سألتك ليه دماغي ساعات بتنمل | فاكر ردك: واثق في الإجابة
قلت دماغك لو منملة حاليا دا احتياجك | كانوا حوالي 12 دقيقة
لما صادفتك في جهنم | ماعرفتش اعبر لك عن اللي داير في دماغي
يمكن أفكاري توصل لو اتقالت في أغاني | جمايلك عليا استحالة الدنيا تنسّيها لي
إحساسي عنك كان صح ودي الخبرة بتأكدها لي | كنت ناسي ولما شفتك وافتكرت
الدايرة ع الضيق دي القاعدة | على قلبي زي الطعنة Henny الـ
مروّق ع السيجارة فيها زعتر | مروّق ع المحفظة بالفراعنة
خلص الأسفلت هنا أوف رود | معايا مهدئات انا دكتور
معايا المزة لابسة كوكو | لافة رقبتها في لؤلؤ
الهيتس ع الفلاشة | والنجوم في السيجارة
البحور في الإزازة | بس الإزازة خلصانة
والسيمون فوميه بقى ع البوفيه | والبواكي بتلعب كاراتيه
بقالنا في اللعبة قد ايه | شوف كنا فين وبقينا فين
ماسك السيجار زي تشي چيفارا | حبّت الكاريزما، حبّت الاثارة
تعالي في البي ام فاكس الدراما | ولا عايزة برادا LV عايزة
ولا عايزة الاتنين الليلة عيد ميلادك | اطلبي اي حاجة هاجيبهالك
صب درينك تالت Belvedere | فين كبايتك املاهالك
عمر الشريف في جيفاغو | مايكل جوردان في شيكاجو
ريال مدريد دي ستيفانو | السقا في افريكانو
مهكّر الجيم GTA الدنيا | نعمل حفلتين نفجر الجيب
Bay خطفة الماذا Bae واخد | شوف كنا فين وبقينا فين
وصلنا وكل الناس دي شاهدة | اننا ثبتنا على المبدأ
الليلة نصفي حساباتنا | بكرا نعوض اللي فاتنا
مارو مارو ع الميكساچ | سايق السوق اكنه لامبو
معايا دروجا معايا الكاش | Django معايا معايا سلاحي زي
والعداد بيصفر زي الحكام | كل الشفرات بتتفك
مولع في الساتيفا عامل دخان | راصص البواكي للسقف
كينزو كارتييه ناخد الاتنين | والتشيرت الفيندي اللي فيه العنين
اول حفلة ليا خدتش فيها جنيه | شوف كنا فين وبقينا فين
انا والجانج جانج جانج جانج | انا والجانج جانج جانج جانج
انا والجانج جانج جانج | انا والجانج
انا مظبوط، دماغي مخبوطة | نوصل الشوت، ناخد الصورة
ناكل السوق، جاي في بطولة | الدنيا مجنونة، الدنيا مجنونة
هو دا النظام | هو دا النظام... هو دا النظام
لا كدا حرام | جت في الاكصضام
اه يا سادة يا كرام | باصص انا على سما زرقة
ماتنساش ان انا ماركة | عادي ولا فارقة
مش برشق | بدور على أرنب
انا الكل في الكل | عادي زي الفل
انت مجيتش غير بالذل | بنطلونها ضيق زي الخلق
جسمها خطير زي الكحل | وانا وانا وانا
مدفع | اجدع
محتاجلي 3 عشان اشبع | ببلع
مش بدفع | بتابع بس مش بشجع
هو دا النظام هو دا النظام | بتحاسب بالجرام
في أي حتة بيعاملوني بإحترام | عديت عليكوا شوفت عنيكوا شوفت الكذب
ماحتجتش اعمل تيست | وملقحتش لو ركزت
نفسياتكوا زي زفت | لابس تشيرت لونه كشك
لا لا لا | سيكاها
فيه عدو فيه رهان | شوفت التطور على فترات
اخر الحصة وزعلكوا الدرجات | تكتيكي بستغل الثغرات
دا شلال | أنا جبال
إثبتلك على حال | من دلوقتي تقولي خال
هو دا النظام هو دا النظام | مين فيكو عطشان؟
حضر الطوفان | دنيا .. إيه يا دنيا
جوة الكونراد .. طالب كونياك | سلسلة في رقبتي .. فيها مومياء
هحفل في لندن .. مع اوباميانج | بضرب الأوفسايد
بضرب الأوفسايد | بضرب انا براحتي شكلك عامل دايت
إفتح الموبايل | خش على البروفايل
اسمعلية تراك | اعتبر دا جايد
هعمل زي ما عايز | مش محتاج مساعدة زي ما انت شايف
عايز الشهرة وفي نفس الوقت منها خايف | بعتتلي بعد المدفع ايموچي شفايف
وش دا إجرام | بابا انا القبطان بابا انا القبطان
بتقول إن إنت جاي | يا عم ولا أي
سايبلكوا لحد شهر ١٠ اللي جاي | ميت ولا حي؟
مستوي ولا ني؟ | في المجال أسلوبي بيبقى طبي زي ال لي
بالليل أنا بتحول | إنت بتجلي، إنا بجود
المفوضات لما بتطول | بقوله عيدهالي من الاول
لو طلعت عرفاني مش هحتاج ارميلها الكرت | قلبها في دماغي بزيت زيتون وشوية خل
الحقيقة طالعة مني ساقعة زي التلج | بكرا تيجي تحت رجلي تاني زي الكلب
هو دا النظام هو دا النظام | وزة من الشيطان
كنت هافيدك يا عم أنا غلطان | هو دا النظام... هو دا النظام
لا كدا حرام | جت في الاكصضام
اي ، سوقت فالمدينة فكل شارع (شارع) | شوفت وشوش حزينة قمت راجع (راجع)
قافل التكييف ومودي ساقع | جبت شقة جديدة وقومت دافع (دافع)
مش عايز اودي فـ ناس ناقصة | ولا عايز اودي فـ ناس فاصلة
ست اصفار و تحط فاصلة | يسطا متقوليش بفة
يسطا متقوليش يسطا | يسطا متقوليش اصلا
اي ، لسه فاكر (فاكر) | ايام ما كنت فان
واروح على الحفلة وفـ ايدي تذاكر | بفكر اسافر (سافر)
بفكر اهاجر (والله؟) | تكسكة بزيادة فـ البلد
يا زميلي بصراحة مش قادر | لقيت كل حاجة زي ما هي
كل الناس ديه لسه زي ما هي | معايا إنزو وعفرت وبنكروز فـ الطالبية
الشمس طلعت واحنا ع الفجرية ، اي | اي ، سوقت فالمدينة فكل شارع (شارع)
شوفت وشوش حزينة قمت راجع (راجع) | قافل التكييف ومودي ساقع
أعوز اذاكر... افتح الدراسات واسيب الجبر | أعوز أريّح، فأتمدد على قضيب القطر
على السوشال، يا إما تعمل سندباد | يا إما تعلن إكتئاب
أبتدي بالإسم، ولا الحرف ولا الفعل | كلم السمسار، صاحب البيت، غلّى السعر
وهنا كل حاجة بتغلى إلا كلمة الشرف | ولما الحاجة بتبقى دوغري نحب نيجيلها من ورا
بس الانجاز قد كدا، لازم نقيس بالمسطرة | ولازم الميستر أجبرك
لازم الميس تكدرك | طب وانا؟ رحت للمصير وقلت له: ها بقى
قال لي: هو انت لسه شفت حاجة؟ | يا عم فهمنا،
خلاص بقى اتنيلنا | هنقعد نتكتم اشرح لنا، انت كبيرنا
مش فاهم انت عايز مني إيه | مش مهم اني اتأخرت، المهم اني جيت
وانا في ابتدائي كنت بسأل نفسي: ازاي؟ | وانا في اعدادي كنت بسأل نفسي: امتي؟
وانا في الجامعة بدأت اسأل نفسي: ليه؟ | دلوقتي بسأل جوجل فين الأجزخانة
ومش باعرف اخد أوامر وابقى ماشي بخط سير | قصدك ايه؟ نفسية طالعة نازلة في اسانسير
فبتغابى وببقى الشخص اللي يقفلها ليلة الافتتاح | مش عايز الاقي عقدي بتبعدني ع النجاح
باكره ان انا طيب، | باكره إني باكره ان انا طيب
مزاجي زفت ومش عارف إفادة حب الناس | نفسي انسى 2016 من غير ما اصب كاس
بادخل جحر الحزن اشوف بس مين اللي هيسأل | وبتخيل لو اختفيت، ايه اللي هيحصل
"طب لما ارجع هايتبسطوا ان انا جيت؟" | بنسى إن الاهتمام عمره ما اشترى بيت
في حوار مع واحد ما بيسمعش، فمليت | من المسؤلية استخبيت
بس ان حد يعاتبني، لا دا عيب | مش مهم اني اتأخرت، المهم اني خفيت
وانا في ابتدائي كنت بسأل نفسي: ازاي؟ | وانا في اعدادي كنت بسأل نفسي: امتي؟
وانا في الجامعة بدأت اسأل نفسي: ليه؟ | دلوقتي بسأل جوجل فين الأجزخانة
دا... طريق اللانهاية | مسك الخريطة هيخليك شغال قراية
موتوري عطل، تانك الديزل قال كفاية | وسط جبال لو جابت ليل حتى الجريء محتاج حماية
بس النقطة السودة بارزة | ولا نقطة بتبُقى شاربة
جت بالصُدفة التوبة خارجة من بقها.. | الكلمة سلعة.. في السموات تتباع
باهاجم الحياة ...بألوان الدفاع | قلقان جت حوادث
شعبان لعند مارس | تعبان ماعادش حاسس
زهقت وصوتي قافش | وطلعت الدور الهامش
نومي عسل... وانا بتاع معاكسة | شبعت منه جاب احلام بطعم النكسة
مغمض عيني... جت أفاعي | برضو رافض... ابقى واعي
في العصر الفضي نتاجر في الحروف ونغش بعض | بقيت ب-كاش... طلع دفع القسط صعب
اكل العيش امر من المر | والنسيان أضر من الشرب
الخبث مزة، فباحب الاحترام | أمل مشيت لسه في حتة الخصام
ماشي سالانسيه.. برعاية قشر البيض | رجعت في يوم لاقيت حاجتها مش في البيت
في الفصل كنت غاااااايب... مستقبلي في رقبتي | افتكروني خااااايب، بس علمت نفسي
وداني القطر، لمحافظة التعالي | رجعني الزمن، لمحطة المعادي
مغمّي عيني، بادور على القرار | أفكار ممنوعة، صوّرها الرادار
قلت لأعصابي: هابدلك لو تعبتي في الخمسة وستين | القدر ما بينهز شباكه حتى لو كان مين
الشفقة مصابة بالشيخوخة | متجهة بالراحة للغيبوبة
- يا اسطى ليه بتفتكر لنفسك وتنسى ليا؟ | - عشان جدار الاحتياج حايش الانسانية
واكتشفت ... بعد تفتيش ماضيا | - اني زي محامي في الفاكانس ماعنديش قضية
وانا في ابتدائي كنت بسأل نفسي: ازاي؟ | وانا في عدادي كنت بسأل نفسي: امتي؟
وانا في الجامعة بدأت اسأل نفسي: ليه؟ | دلوقتي بسأل جوجل فين الأجزخانة
خوفي الوحيد هو خوفي مني | الصبر مر بس اليأس موتي وسمي
قولت لها: في عز ما انتي همجية بتترددي | حلاوة العالم انه مش منطقي
مثلاً... | اتشال الطبق من قدامي ولسه باكل
مش فاهم التفاهة في التفاؤل | مش عايز ضلمة، فتحت اللمبة
اخرتنا اتنين متر ونص تحت الرملة | طموحي بيتسرع ويتوه
فقلت أمنياتي لنجمة بتطلع في الروح | عايز اشوف العيلة كل سنة أعلى
عايز اعيش ومش هادوّر على معنى | وانا في ابتدائي كنت بسأل نفسي: ازاي؟
وانا في اعدادي كنت بسأل نفسي: امتي؟ | وانا في الجامعة بدأت اسأل نفسي: ليه؟
سنة في التانية و احنا في الدوامة | ضيعت البوصلة بس وصلت بالسلامة
لسة صاحي | عايز ربح صافي
بموت احساسي | بتغدي علماشي
مفيش حاجة كتيرة عليا بشيل الهموم علي كتافي | ايه
راجل و عارف مقامي | عمري ما رجعت فكلامي ×²
محدش حاسس ليه باللي جوايا | كله اختفي وقت الترباية
مش عارف انت معاهم ولا معايا | مش فاضي افكر فهحطك فالمراية
سنة فالتانية و احنا فالدوامة | هنضحي باللي مش علي هوانا
ليه وجودي بيعصبك | لما اشوفك هعرفك
بيحبوني و انا في صفك | في اي حتة بيحبوني
مش فالكلام العمومي | محبش اتكلم في همومي
احنا الوحاد اللي كده ×² | سنة فالتانية و احنا فالدوامة
ضيعت البوصلة بس وصلت بالسلامة | لسة صاحي
عايز ربح صافي | بموت احساسي
بتغدي علماشي | مفيش حاجة كتيرة عليا بشيل الهموم علي كتافي
راجل و عارف مقامي | عمري ما رجعت فكلامي ×²
ويا العصابة فالنادي الاشتراك هنا غالي | قاعد علي القمة مع ناسي
لابس نضارة القذافي | ظابط اداء زي اتشاڤي
كل العيال دي تسالي | قولهم قابلوني الليلة دي
ورا مصنع الكراسي | عندي الفرقة هتخلي العيون مكسورة
درع الدوري مش هيكفي فين السوبر | بتكلم دولي مع العيلة فالمقصورة
صوتك عالي بس ميكسبش بطولة | اوعي سيرتي تيجي علي لسانك
حاطط رجل في اسماعلية ورجل في برشلونة | وانا في السعودية بيقولولي شلونك
بتغنو الحلزونة ياما الحلزونة | مرو مرو مرو مروادونا
وانا في رجلي الكورة ، بقفل الفورة | خد اشربلك مية ، انا وقفت في زورك
مش محتاج اتصيت ، عمري ما هتغير | نفسك قصير ، انت لسة صغير
انت تلميذ | ممكن تخرس محتاج تركيز
سما زرقة ، مـ البرابيز | اهدى اهدى ، اهدالي بليز
(Aye) اهدى بدل ما الطشلك | انا وعفروتو في المطبخ
(لا مش محتاجين نسلم (لا | (لا مش محتاجين نقافلك (لا
(نقطة من اول السطر (سطر | (انا وعفروتو في القطر (قطر
(لازم نزود الضغط (ضغط | (مفيش حاجة بتيجي بالصبر (لا
(مفيش حاجة بتيجي بالساهل (لا | (انا وعفروتو في الساحل (بحر
(عايز منتج متكامل (اه | (خد نمرتي من الاخر (خد
(خد تعالى رايح فين (فين | (انا وعفرت في الكافيه (كافيه
كانت واحدة بقوا اتنين | لا مبقاش عندي مشاعر
لما لاقتهم مش سالكين معايا قومت باعد | هاري نفسك والجمهور بردو مش متفاعل
انا جيت خلصت اربع اغاني وانا قاعد | و عالكيبورد قومت لاعب
عادي سهلة شكلك تعبان | في سرير جوة ماتخش تنام
تيجي مبسوط تمشي زعلان | دي مش اغاني دي افلام
